NO ./img/mario/brick_mario.xpm
               SO ./img/mario/interrogation_point_mario.xpm	
EA ./img/mario/mario_mushroom.xpm






DO ./img/mario/tileset_dungeon_PNG.xpm

WE              ./img/mario/mario_pipe.xpm
   F	   	0,200,0

CO ./img/mario/coin_mario.xpm



C 0,128,255

111111111111111111111111111111111111111
100000100C000000000000000000000000001
1000001000000101111111111000000011111
100C0000EC00C0001000000001C0000000101111
11111111D111111111110010D001000001001011
10101000000000101111111111111111111111
1C00000000000010000000000000D0000C0001
1100000001111110000000C00011100011111
10011D111000001100C0000000111000011
111000000000000000000110000010110001
111111100111001000000100000000111111
11000001111C0010000010000000001
10C0000D00001110000001000000111
1111111111110000C0000D0101011
            11111111111111111