NO ./img/hiver/neige.xpm
SO ./img/hiver/pinguin.xpm


C 200,30,38
CO ./img/mario/coin_mario.xpm
EA              ./img/hiver/sapin.xpm

                F 255,100,0
WE ./img/hiver/snowman.xpm

DO ./img/mario/tileset_dungeon_PNG.xpm          

        1111111111111111111111111
        10000010C011000000000011 1
        101100000111000000000001 1
        1001000N000000000000000111
111111111011C00001110000000000001
100000000011000001110111111111111
1111011111111101110C000010001
1111D111111111011101010010001    1
11000000110101011100000010001   101
100000000000000011000000D0001    1       
1000000000000000110101001C001
110000C111010101111101111000111
11110111 1110101 101111010001
11111111 1111111 111111111111
1

