NO ./img/mario/brick_mario.xpm
SO ./img/mario/interrogation_point_mario.xpm	
WE ./img/mario/mario_pipe.xpm
EA ./img/mario/mario_mushroom.xpm
DO ./img/mario/tileset_dungeon_PNG.xpm
CO ./img/mario/coin_mario.xpm

   F	   	0,200,0




C 0,128,255

11111111111111111
100000100S0000001
100000100C0100101
10000011000100001
11111111D11111111
10101000000000D01  
10000000000000101
11111111111111111