NO ./img/origin/purplestone.xpm
SO ./img/origin/purplestone.xpm
WE ./img/origin/purplestone.xpm
EA ./img/origin/purplestone.xpm
   F	   	255,0,255




C 0,128,255

11111111111111111
10000001000000001
10000000000001001
10001010001000001
10000000W00000011
10100001000000101
10000000000000101
11111111111111111