NO ./img/origin/eagle.xpm
SO ./img/origin/colorstone.xpm

WE ./img/origin/eagle.xpm
EA ./img/origin/greystone.xpm
    F	   	12,00,223



C 200,30,255

11111111111111111
10000001000000001
10000000000000001
10001010001000001
100W0000000000001
10000000N00000001
10000000000000001
11111111111111111